TOK = "countries/Tokio.txt"
PAS = "countries/California.txt"
FLO = "countries/Florida.txt"
AZO = "countries/Azovgrad.txt"
ALM = "countries/Синдикат Эмеранция.txt"
SSR = "countries/Синдикалистическая Средиморская Республика.txt"
ENC = "countries/Калифорнийская Пролетарская Зона.txt"
NSS = "countries/Киевградская Окупационная Зона.txt"
MAR = "countries/Синдикат Марленд.txt"
NSS = "countries/Киевградская Окупационная Зона.txt"
HAL = "countries/Синдикат Халбенс.txt"
REG = "countries/Регенство Киевград.txt"
SFG = "countries/С.Ф.Г.txt"
SST = "countries/Социалистическая Республика Токиостан.txt"
KIV = "countries/Киевград.txt"
CSG = "Северная Калифорнийская Республика.txt"
NFK = "countries/Новый Киевград.txt"
BGR = "countries/Синеград.txt"
BPA = "countries/Синеградская Народная Армия.txt"
BAN = "countries/Бангистан.txt"
TAT = "countries/Татарградская Автономия.txt"
NOV = "countries/Республика Новоград.txt"
CAR = "countries/Зона Контроля Картеля.txt"
CSN = "countries/Комитет спасения нации.txt"
DEM = "countries/Демократическая Республика.txt"
YEL = "countries/Асверленд.txt"
GEO = "countries/Гелиополис.txt"
ACZ = "countries/Анархо-Капиталистическая Зона.txt"
ATZ = "countries/Анархо-Трансгуманистическая Территория.txt"
ACT = "countries/Анархо-Коммунистическая Территория.txt"
AST = "countries/Анархо-Синдикалистическая Территория.txt"
EAZ = "countries/Зона Экологической Автократии.txt"
APL = "countries/Земля Анархо-Примитивистов.txt"
HAR = "countries/Харенское Государство.txt"
STR = "countries/Стелзианская Республика.txt"
PZD = "countries/PZD.txt"
VFR = "countries/Свободная Республика Вельмиция.txt"
RED = "countries/Редоград.txt"
SRO = "countries/Синдикалистическая Народная Республика Остра.txt"
SRY = "countries/Синдикалистическая Народная Республика Урград.txt"
AKT = "countries/Анархо-Киевград.txt"
NRR = "countries/Новый Редград.txt"
TAB = "countries/Братство Атома.txt"
TAR = "countries/Альтерград.txt"
TWB = "countries/Белое Братство.txt"
WPR = "countries/Вестпорт.txt"
WBD = "countries/Веббильшмилд.txt"
WSR = "countries/Вайтоградская Социалистическая Республика.txt"
NSC = "countries/Новый Сиетл.txt"
TWC = "countries/Конфедерация Вайтбурга.txt"
NTC = "countries/Конфедерация Племен Нортланда.txt"
NRS = "countries/Государство Нового рассвета.txt"
CCC = "countries/Конфедерация Великих Городов.txt"
FND = "countries/Фондифика.txt"
FRR = "countries/Свободная Республика Редоград.txt"
ARM = "countries/Республика Армляндия.txt"
WMR = "countries/Восточный Мадерн.txt"
FND = "countries/Фондифика.txt"
FRR = "countries/Свободная Республика Редоград.txt"
ARM = "countries/Республика Армляндия.txt"
WMR = "countries/Восточный Мадерн.txt"
NGA = "countries/Гвардейская Армия Новограда.txt"
BZN = "countries/Банзаеград.txt"
TVB = "countries/Веренское Боронство.txt"
TNR = "countries/Республика Морград.txt"
CRD = "countries/Государство Красного Дракона.txt"
CUB = "countries/Республика Кубания.txt"
SGR = "countries/Скамейградская Республика.txt"
TOU = "countries/Окраинский Союз.txt"
FCK = "countries/Вольный Город Киевград.txt"
KSR = "countries/Социалистическая Республика Киевград.txt"
TKK = "countries/Кирибистанское Королевство.txt"
TSI = "countries/Швейцаринская Империя.txt"
TLR = "countries/Телембурская Либеральная Республика.txt"
TLI = "countries/Литовужская Империя.txt"
MGR = "countries/Малосийская Зеленая Республика.txt"
MCG = "countries/ЧВК «Гипербия».txt"
NAD = "countries/Новоарминистанград.txt"
CHN = "countries/Республика Чан-сзи.txt"
GLZ = "countries/Зеленоградская Зона Свободы.txt"
FRK = "countries/Свободная Республика Киробург.txt"
TVF = "countries/Валенская Федерация.txt"
ACO = "countries/Вольная Конфедерация Остравии.txt"
THG = "countries/Техногорск.txt"
BNA = "countries/Синеградская Национальная Ассамблея.txt"
BSR = "countries/Синеградская Синдикалистическая Республика.txt"
ATK = "countries/Вольные Территории.txt"
TKC = "countries/Кривийская Конфедерация.txt"
BKA = "countries/Синеградское Казачье Войско.txt"
LNR = "countries/Свободонорская Республика.txt"
SNG = "countries/Швейцкомпим Новый Киевград.txt"
BER = "countries/Березань.txt"
MAT = "countries/Матросия.txt"
RDR = "countries/Ракасовская Демократическая Республика.txt"
KMK = "countries/Катмандск.txt"
TBR = "countries/Горошбург.txt"
SWG = "countries/Швейцнариноградск.txt"
TVC = "countries/Валиклендская Конфедерация.txt"
NGR = "countries/Новогорск.txt"
VNK = "countries/Веннцшнаск.txt"
TKR = "countries/Кандаурская Республика.txt"
LHT = "countries/Лехтенштат.txt"
SIK = "countries/Швейцнаринский Островное Королевство.txt"
TZS = "countries/Женханская Область.txt"
TOR = "countries/Орестград.txt"
TTZ = "countries/Технозаводск.txt"
TZU = "countries/Жень Юнь.txt"
TPR = "countries/Пельмбург.txt"
HRH = "countries/Святая Республика Халандия.txt"
FRV = "countries/Свободная Республика Вельмиция.txt"
WTL = "countries/Вайтланд.txt"
HCR = "countries/Республика Имени Святого Христа.txt"
TMK = "countries/Королевство Мадерн.txt"
CAN = "countries/Канляндия.txt"
TKB = "countries/Княжество Белогорское.txt"
GLU = "countries/Великоградский Союз Свободы.txt"
TSG = "countries/Серебряная Гвардия.txt"
TBK = "countries/Чёрный Консулат.txt"
GLU = "countries/Великоградский Союз Свободы.txt"
GPR = "countries/Патриотическая Республика Великограда.txt"
TSC = "countries/Тёмный Конклав.txt"
RWR = "countries/Красная Республика.txt"









